R 1920 1080

NO  ./Textures/walls/Texture_1_Diffuse_64.xpm

SO  ./Textures/walls/Texture_2_Diffuse_64.xpm

WE  ./Textures/walls/Texture_3_Diffuse_64.xpm

EA  ./Textures/walls/Texture_4_Diffuse_64.xpm
               
S   ./Textures/npc/npcmove4.xpm

F 192,192,192

C 200,200,200

1111111111111111111111111
1000000000000001000000001
1000000001111101000000001
1000000001000101000000001
100000000101N101000000001
1000000001011101000000001
1000000001000001000000001
1000000001111111000000001
1000000000000000000000001
1111111111111111011111111