R 1920 1080

NO  ./Textures/walls/Texture_1_Diffuse_64.xpm

SO  ./Textures/walls/Texture_2_Diffuse_64.xpm

WE  ./Textures/walls/Texture_3_Diffuse_64.xpm

EA  ./Textures/walls/Texture_4_Diffuse_64.xpm

S   ./Textures/npc/npcmove4.xpm

F 200,200,200

C 200,200,200

111111111111111
100000E0000011111111
10002000000001100001
1000000000000100N001
11111111111111111111

